
 B B M M B B
 B B MMM B B
 B B M M B B
 B B     B B

M MM     MM M
     B B
 B B MBM B B
 B B B B B B
 B B     B B
 B B BBB B B
    PBFB