 c  C   A  O
B          B
B          B
B    M     B
B    M     B
B M  M     B
B          B



     BBB   B
    PBFB   B